0WWWWW0
WW000WW
W00W00W
W00X00W
W00X00W
WW0X0WW
0WWWWW0
1,2
3,2
3,3
3,4